||||||||||||||||||||||||||||
|..........................|
|.||||.||.||||||||.||.||||.|
|.||||.||.||||||||.||.||||.|
|......||....||....||......|
|.|||||||..........|||||||.|
|.||||||| || || || |||||||.|
..........|| || ||..........
|.||||.||.||....||.||.||||.|
|.||||.||.||||||||.||.||||.|
|.||...||.||||||||.||...||.|
|.||.||||..........||||.||.|
|.||.||||.|||--|||.||||.||.|
.......||.|______|.||.......
|.||||.||.||||||||.||.||||.|
|.|__|.||..........||.|__|.|
|.||||.||.||||||||.||.||||.|
|..........................|
||||||||||||||||||||||||||||
