||||||||||||||||||||||||||||
|..........................|
|.||||||| |||||||| |||||||.|
|.||||||| |||||||| |||||||.|
|...||.......||.......||...|
|||.||.||..........||.||.|||
__|.||.||.||.||.||.||.||.|__
|||.||.||.||.||.||.||.||.|||
|......||.||....||.||......|
|||.|||||.||||||||.|||||.|||
|||.|||||.||||||||.|||||.|||
|......||..........||......|
|||.||.||.|||--|||.||.||.|||
|||.||.||.|______|.||.||.|||
|...||....||||||||....||...|
|.|||||||..........|||||||.|
|.|||||||.||||||||.|||||||.|
|..........................|
||||||||||||||||||||||||||||
