||||||||||||||||||||||||||||
|............||............|
|.||||.||.||.||.||.||.||||.|
|.||||.||.||.||.||.||.||||.|
|.||...||.||.||.||.||...||.|
|.||.||||..........||||.||.|
|.||.||||.||.||.||.||||.||.|
|......||.||.||.||.||......|
|.||||.||....||....||.||||.|
|.||||.||.||||||||.||.||||.|
|...||.||.||||||||.||.||...|
|||.||................||.|||
__|.||.||.|||--|||.||.||.|__
|||.||.||.|______|.||.||.|||
|......||.||||||||.||......|
|.|||||||..........|||||||.|
|.|||||||.||||||||.|||||||.|
|..........................|
||||||||||||||||||||||||||||
