||||||||||||||||||||||||||||
|............||............|
|.||||.||.||.||.||.||.||||.|
|.||||.||.||.||.||.||.||||.|
|...||.||..........||.||...|
|||.||.||..........||.||.|||
|||.||.||.||.||.||.||.||.|||
..........||.||.||..........
|.|||||||....||....|||||||.|
|.|||||||.||||||||.|||||||.|
|......||.|______|.||......|
|||.||.||..........||.||.|||
__|.||.||.|||--|||.||.||.|__
|||.||.||.|______|.||.||.|||
....||....||||||||....||....
|.|||||||..........|||||||.|
|.|||||||.||||||||.|||||||.|
|..........................|
||||||||||||||||||||||||||||
