||||||||||||||||||||||||||||
|......||..........||......|
|.||||.||.||||||||.||.||||.|
|.||||.||.||||||||.||.||||.|
|............||............|
|.||||.||..........||.||||.|
|.||||.|| || || || ||.||||.|
|...||.|| || || || ||.||...|
|||.||....||....||....||.|||
__|.||.||.||||||||.||.||.|__
|||.||.||.||||||||.||.||.|||
|......||..........||......|
|||.|||||.|||--|||.|||||.|||
|||.|||||.|______|.|||||.|||
|......||.||||||||.||......|
|.||||.||..........||.||||.|
|.||||.||.||||||||.||.||||.|
|..........................|
||||||||||||||||||||||||||||
