||||||||||||||||||||||||||||
|............||............|
|.||.||||.||.||.||.||||.||.|
|.||.||||.||.||.||.||||.||.|
|.||...||....||....||...||.|
|.||||.||..........||.||||.|
|.||||.||.||||||||.||.||||.|
|..........................|
|.|||||||.||||||||.|||||||.|
|.|||||||.|______|.|||||||.|
|......||.||||||||.||......|
|.||||.||..........||.||||.|
|.||||.||.|||--|||.||.||||.|
|.||......|______|......||.|
|.||.||||.||||||||.||||.||.|
|.||.|__|..........|__|.||.|
|.||.||||.||||||||.||||.||.|
|..........................|
||||||||||||||||||||||||||||
