||||||||||||||||||||||||||||
|......||..........||......|
|.||||.||.||||||||.||.||||.|
|.|__|.||.||||||||.||.|__|.|
|.||||.||.||....||.||.||||.|
............................
|.|||||||.||.||.||.|||||||.|
|.|||||||.||.||.||.|||||||.|
|.||.........||.........||.|
|.||.||||.||||||||.||||.||.|
|.||.||||.|______|.||||.||.|
............................
|.||||.||.|||--|||.||.||||.|
|.||||.||.|______|.||.||||.|
|.||...||.||||||||.||...||.|
|.||.||||..........||||.||.|
|.||.||||.||||||||.||||.||.|
|..........................|
||||||||||||||||||||||||||||
