||||||||||||||||||||||||||||
|..........................|
|.||||.||.||||||||.||.||||.|
|.||||.||.||||||||.||.||||.|
|.||...||....||....||...||.|
|.||.||||..........||||.||.|
|.||.||||.||.||.||.||||.||.|
..........||.||.||..........
|.||||.||.||....||.||.||||.|
|.|__|.||.||||||||.||.|__|.|
|.||||.||.||||||||.||.||||.|
|......||..........||......|
|.||.||||.|||--|||.||||.||.|
|.||.||||.|______|.||||.||.|
|.||......||||||||......||.|
|.|||||||..........|||||||.|
|.|||||||.||||||||.|||||||.|
|..........................|
||||||||||||||||||||||||||||
