||||||||||||||||||||||||||||
|.........||....||.........|
|.||||.||.||.||.||.||.||||.|
|.|__|.||.||.||.||.||.|__|.|
|.||||.||.||.||.||.||.||||.|
|......||..........||......|
|.||.||||.||||||||.||||.||.|
|.||.||||.||||||||.||||.||.|
|.||....................||.|
|.|||||||.||||||||.|||||||.|
|.|||||||.||||||||.|||||||.|
|..........................|
|.||||.||.|||--|||.||.||||.|
|.||||.||.|______|.||.||||.|
|.||...||.||||||||.||...||.|
|.||.||||..........||||.||.|
|.||.||||.||||||||.||||.||.|
|..........................|
||||||||||||||||||||||||||||
