||||||||||||||||||||||||||||||||||
|................................|
||||.|||||.|..........|.|||||.||||
||||.|||||.|..|____|..|.|||||.||||
|.......||.|..||||||..|.||.......|
||||.||.||.|..........|.||.||.||||
||||.||.||.|..||||||..|.||.||.||||
|....||.||.|..||||||..|.||.||....|
||||.||....|..........|....||.||||
___|.|||||.||||.||.||||.|||||.|___
||||.|||||.||||.||.||||.|||||.||||
|....||....................||....|
||||.||.||||.|||--|||.||||.||.||||
||||.||.||||.|______|.||||.||.||||
|.........||.||||||||.||.........|
|.||.||||.||..........||.||||.||.|
|.||.||||.||.||||||||.||.||||.||.|
|.||..........................||.|
|.|||||.||||.||||||||.||||.|||||.|
|.|||||.||||.||||||||.||||.|||||.|
|................................|
||||||||||||||||||||||||||||||||||
