||||||||||||||||||||||||||||||||||
|................................|
|||.|||||.||..........||.|||||.|||
__|.|||||.||.||||||||.||.|||||.|__
|||.||....||....||....||....||.|||
|...||.||.||.||.||.||.||.||.||...|
|||.||.||.||.||.||.||.||.||.||.|||
|||.||.||.||.||.||.||.||.||.||.|||
.......||................||.......
|||.||||||||.||||||||.||||||||.|||
|||.||||||||.||||||||.||||||||.|||
.......||................||.......
|||.||.||.||.|||--|||.||.||.||.|||
|||.||.||.||.|______|.||.||.||.|||
|...||....||.||||||||.||....||...|
|.|||||||.||..........||.|||||||.|
|.|||||||.||.||||||||.||.|||||||.|
|.........||..........||.........|
|.||||.|||||.||||||||.|||||.||||.|
|.||||.|||||.||||||||.|||||.||||.|
|................................|
||||||||||||||||||||||||||||||||||
