||||||||||||||||||||||||||||||||||
|...............||...............|
|||.|||||.||.||.||.||.||.|||||.|||
|||.|||||.||.||.||.||.||.|||||.|||
.......||.||..........||.||.......
|.||||.||.||..........||.||.||||.|
|.||||.||.||.||.||.||.||.||.||||.|
|...||.||.||.||.||.||.||.||.||...|
|||.||.......||....||.......||.|||
__|.||.|||||.||||||||.|||||.||.|__
|||.||.|||||.||||||||.|||||.||.|||
..........||..........||..........
|||.|||||.||.|||--|||.||.|||||.|||
|||.|||||.||.|______|.||.|||||.|||
|......||.||.||||||||.||.||......|
|.||||.||.||..........||.||.||||.|
|.||||.||.||.||||||||.||.||.||||.|
|................................|
||||||||||||||||||||||||||||||||||
