||||||||||||||||||||||||||||||||||
|.........||..........||.........|
|||.|||||.||..........||.|||||.|||
|||.|||||.||.||||||||.||.|||||.|||
|......||.......||.......||......|
|||.||.||.||.||.||.||.||.||.||.|||
|||.||.||.||.||.||.||.||.||.||.|||
|...||.||.||.||.||.||.||.||.||...|
|.||||....||..........||....||||.|
|.||||.|||||.||||||||.|||||.||||.|
|...||.|||||.||||||||.|||||.||...|
|||.||......................||.|||
|||.||.||.||.|||--|||.||.||.||.|||
|......||.||.|______|.||.||......|
|||.||.||.||.||||||||.||.||.||.|||
__|.||.||.||..........||.||.||.|__
|||.||.||.||.||||||||.||.||.||.|||
|...||....||..........||....||...|
|.||||.|||||.||||||||.|||||.||||.|
|.||||.|||||.||||||||.|||||.||||.|
|................................|
||||||||||||||||||||||||||||||||||
