||||||||||||||||||||||||||||||||||
|................................|
|||.|||||.||.||||||||.||.|||||.|||
|||.|||||.||.||||||||.||.|||||.|||
..........||....||....||..........
|||.||||||||..........||||||||.|||
|||.||||||||.||.||.||.||||||||.|||
|.........||.||.||.||.||.........|
|||.|||||.||.||....||.||.|||||.|||
|||.|||||.||.||||||||.||.|||||.|||
|......||.||.||||||||.||.||......|
|||.||.||................||.||.|||
__|.||.||.||.|||--|||.||.||.||.|__
|||.||.||.||.|______|.||.||.||.|||
....||....||.||||||||.||....||....
|.||||.|||||..........|||||.||||.|
|.||||.|||||.||||||||.|||||.||||.|
|................................|
||||||||||||||||||||||||||||||||||
