||||||||||||||||||||||||||||||||||
|................................|
|||.||||||||.||||||||.||||||||.|||
|||.||||||||.||||||||.||||||||.|||
|......||....||....||....||......|
|||.||.||.||..........||.||.||.|||
__|.||.||.||.||.||.||.||.||.||.|__
|||.||.||.||.||.||.||.||.||.||.|||
|...||....||....||....||....||...|
|.|||||||.||.||||||||.||.|||||||.|
|.|||||||.||.|______|.||.|||||||.|
|.........||..........||.........|
|||.||.|||||.|||--|||.|||||.||.|||
|||.||.|||||.|______|.|||||.||.|||
|...||.......||||||||.......||...|
|.||||.|||||..........|||||.||||.|
|.||||.|||||.||||||||.|||||.||||.|
|................................|
||||||||||||||||||||||||||||||||||
