||||||||||||||||||||||||||||||||||
|...............||...............|
|||.|||||.||.||.||.||.||.|||||.|||
|||.|||||.||.||.||.||.||.|||||.|||
|......||.||.||.||.||.||.||......|
|.||||.||.||..........||.||.||||.|
|.||||.||.||.||.||.||.||.||.||||.|
|...||.||.||.||.||.||.||.||.||...|
|||.||....||....||....||....||.|||
__|.||.|||||.||||||||.|||||.||.|__
|||.||.|||||.||||||||.|||||.||.|||
|................................|
|||.||.|||||.|||--|||.|||||.||.|||
|||.||.|||||.|______|.|||||.||.|||
|...||....||.||||||||.||....||...|
|.|||||||.||..........||.|||||||.|
|.|||||||.||.||||||||.||.|||||||.|
|................................|
||||||||||||||||||||||||||||||||||
