||||||||||||||||||||||||||||||||||
|................................|
|.||.||||.||..........||.||||.||.|
|.||.|__|.||.||.||.||.||.|__|.||.|
|.||.||||.||....||....||.||||.||.|
|.||......||.||||||||.||......||.|
|.||||.||.||.||||||||.||.||.||||.|
|.||||.||.||..........||.||.||||.|
|.||...||.||..........||.||...||.|
|.||.||||.||.|______|.||.||||.||.|
|.||.||||.||.||||||||.||.||||.||.|
..................................
||||.||||.||.|||--|||.||.||||.||||
||||.||||.||.|______|.||.||||.||||
|.........||.||||||||.||.........|
||||.||.||||..........||||.||.||||
||||.||.||||.||||||||.||||.||.||||
|....||....................||....|
|.|||||.||||.||||||||.||||.|||||.|
|.|||||.||||.||||||||.||||.|||||.|
|................................|
||||||||||||||||||||||||||||||||||
