||||||||||||||||||||||||||||||||||
|................................|
|||.||.|||||..........|||||.||.|||
|||.||.|||||.||.||.||.|||||.||.|||
|...||....||....||....||....||...|
|||.|||||.||.||||||||.||.|||||.|||
|||.|||||.||.||||||||.||.|||||.|||
..................................
|||.||.|||||..........|||||.||.|||
__|.||.|||||.|______|.|||||.||.|__
|||.||....||.||||||||.||....||.|||
|...||.||.||..........||.||.||...|
|.||||.||.||.|||--|||.||.||.||||.|
|.||||.||....|______|....||.||||.|
.......||.||.||||||||.||.||.......
|.||.||||.||..........||.||||.||.|
|.||.||||.||.||||||||.||.||||.||.|
|.||......||..........||......||.|
|.|||||.||||.||||||||.||||.|||||.|
|.|||||.||||.||||||||.||||.|||||.|
|................................|
||||||||||||||||||||||||||||||||||
