||||||||||||||||||||||||||||||||||
|................................|
|||.||.|||||..........|||||.||.|||
__|.||.|||||.||.||.||.|||||.||.|__
|||.||....||....||....||....||.|||
|...||.||.||.||.||.||.||.||.||...|
|.||||.||.||.||.||.||.||.||.||||.|
|.||||.||.||.||.||.||.||.||.||||.|
|......||................||......|
||||.|||||||.||||||||.|||||||.||||
||||.|||||||.||||||||.|||||||.||||
|................................|
||||.||||.||.|||--|||.||.||||.||||
||||.||||.||.|______|.||.||||.||||
|.........||.||||||||.||.........|
|.||.|||||||..........|||||||.||.|
|.||.|||||||.||||||||.|||||||.||.|
|.||..........................||.|
|.||||.|||||.||||||||.|||||.||||.|
|.||||.|||||.||||||||.|||||.||||.|
|................................|
||||||||||||||||||||||||||||||||||
