||||||||||||||||||||||||||||||||||
|................................|
|||.||||||||.||||||||.||||||||.|||
|||.||||||||.||||||||.||||||||.|||
|.........||....||....||.........|
|.|||||||.||..........||.|||||||.|
|.|||||||.||.||.||.||.||.|||||||.|
|....||......||.||.||......||....|
||||.||.||||.||....||.||||.||.||||
||||.||.||||.||||||||.||||.||.||||
|.........||.||||||||.||.........|
|.||.||||.||..........||.||||.||.|
|.||.|__|.||.|||--|||.||.|__|.||.|
|.||.||||.||.|______|.||.||||.||.|
|.||.........||||||||.........||.|
|.|||||.||||..........||||.|||||.|
|.|||||.||||.||||||||.||||.|||||.|
|................................|
||||||||||||||||||||||||||||||||||
