||||||||||||||||||||||||||||||||||
|................................|
|||.||.|||||..........|||||.||.|||
|||.||.|||||.||||||||.|||||.||.|||
|...||..........||..........||...|
|.||||.|||||.||.||.||.|||||.||||.|
|.||||.|||||.||.||.||.|||||.||||.|
|.........||.||.||.||.||.........|
|||.|||||.||..........||.|||||.|||
|||.|||||.|| |||||||| ||.|||||.|||
|......||.|| |||||||| ||.||......|
|||.||.||................||.||.|||
__|.||.||.||.|||--|||.||.||.||.|__
|||.||.||.||.|______|.||.||.||.|||
|...||....||.||||||||.||....||...|
|.|||||||.||..........||.|||||||.|
|.|||||||.||.||||||||.||.|||||||.|
|.........||..........||.........|
|.||||.|||||.||||||||.|||||.||||.|
|.||||.|||||.||||||||.|||||.||||.|
|................................|
||||||||||||||||||||||||||||||||||
