||||||||||||||||||||||||||||||||||
|................................|
|||.||||||||..........||||||||.|||
|||.||||||||.||||||||.||||||||.|||
|......||....||....||....||......|
|.||||.||.||.||.||.||.||.||.||||.|
|.||||.||.||.||.||.||.||.||.||||.|
|...||.||.||.||.||.||.||.||.||...|
|||.||....||..........||....||.|||
__|.||.|||||.||||||||.|||||.||.|__
|||.||.|||||.|______|.|||||.||.|||
..................................
|||.|||||.||.|||--|||.||.|||||.|||
|||.|||||.||.|______|.||.|||||.|||
|......||.||.||||||||.||.||......|
|||.||.||.||..........||.||.||.|||
|||.||.||.||.||||||||.||.||.||.|||
|...||....||..........||....||...|
|.||||.|||||.||||||||.|||||.||||.|
|.||||.|||||.||||||||.|||||.||||.|
|................................|
||||||||||||||||||||||||||||||||||
