||||||||||||||||||||||||||||||||||
|................................|
|||.||||||||.||||||||.||||||||.|||
|||.||||||||.||||||||.||||||||.|||
|......||.......||.......||......|
|.||||.||.||..........||.||.||||.|
|.|__|.||.||.||.||.||.||.||.|__|.|
|.||||.||.||.||.||.||.||.||.||||.|
..........||.||....||.||..........
|.||.|||||||.||||||||.|||||||.||.|
|.||.|||||||.||||||||.|||||||.||.|
|.||..........................||.|
|.||||.||.||.|||--|||.||.||.||||.|
|.||||.||.||.|______|.||.||.||||.|
|.||...||.||.||||||||.||.||...||.|
|.||.||||.||..........||.||||.||.|
|.||.||||.||.||||||||.||.||||.||.|
|................................|
||||||||||||||||||||||||||||||||||
