||||||||||||||||||||||||||||||||||
|................................|
|||.||||||||.||||||||.||||||||.|||
|||.||||||||.||||||||.||||||||.|||
|......||.......||.......||......|
|||.||.||.||..........||.||.||.|||
|||.||.||.||.||.||.||.||.||.||.|||
|...||....||.||.||.||.||....||...|
|.||||.|||||.||....||.|||||.||||.|
|.||||.|||||.||||||||.|||||.||||.|
|.........||.||||||||.||.........|
|||.||.||.||..........||.||.||.|||
__|.||.||.||.|||--|||.||.||.||.|__
|||.||.||.||.|______|.||.||.||.|||
|...||.||....||||||||....||.||...|
|.||||.|||||..........|||||.||||.|
|.||||.|||||.||||||||.|||||.||||.|
|................................|
||||||||||||||||||||||||||||||||||
