||||||||||||||||||||||||||||||||||
|...............||...............|
|||.|||||.||.||.||.||.||.|||||.|||
|||.|||||.||.||.||.||.||.|||||.|||
|......||....||.||.||....||......|
|||.||.||.||..........||.||.||.|||
__|.||.||.||.||.||.||.||.||.||.|__
|||.||.||.||.||.||.||.||.||.||.|||
|...||....||....||....||....||...|
|.||||.|||||.||||||||.|||||.||||.|
|.||||.|||||.|______|.|||||.||||.|
|.........||..........||.........|
|.||.||||.||.|||--|||.||.||||.||.|
|.||.||||.||.|______|.||.||||.||.|
|.||...||.||.||||||||.||.||...||.|
|.||||.||.||..........||.||.||||.|
|.||||.||.||.||||||||.||.||.||||.|
|................................|
||||||||||||||||||||||||||||||||||
