||||||||||||||||||||||||||||||||||
|................................|
||||.|||||||..........|||||||.||||
||||.|||||||.||.||.||.|||||||.||||
..........||....||....||..........
|.||.||||.||.||||||||.||.||||.||.|
|.||.||||.||.||||||||.||.||||.||.|
|.||..........................||.|
|.|||||.||||..........||||.|||||.|
|.|||||.||||.|______|.||||.|||||.|
|.||......||.||||||||.||......||.|
|.||.||||.||..........||.||||.||.|
|.||.|__|.||.|||--|||.||.|__|.||.|
|.||.||||.||.|______|.||.||||.||.|
.............||||||||.............
|.||||.||.||..........||.||.||||.|
|.||||.||.||.||||||||.||.||.||||.|
|.||...||.||..........||.||...||.|
|.||.||||.||.||||||||.||.||||.||.|
|.||.||||.||.||||||||.||.||||.||.|
|................................|
||||||||||||||||||||||||||||||||||
