||||||||||||||||||||||||||||||||||
|...............||...............|
|||.||.|||||.||.||.||.|||||.||.|||
|||.||.|||||.||.||.||.|||||.||.|||
|...||....||.||.||.||.||....||...|
|.||||.||.||.||....||.||.||.||||.|
|.||||.||.||.||.||.||.||.||.||||.|
|......||.||.||.||.||.||.||......|
|||.|||||................|||||.|||
|||.|||||.||.||||||||.||.|||||.|||
|.........||..........||.........|
|||.||.|||||..........|||||.||.|||
__|.||.|||||.|||--|||.|||||.||.|__
|||.||....||.|______|.||....||.|||
|...||.||.||.||||||||.||.||.||...|
|.||||.||.||..........||.||.||||.|
|.||||.||.||.||||||||.||.||.||||.|
|......||................||......|
|.||||||||||.||||||||.||||||||||.|
|.||||||||||.||||||||.||||||||||.|
|................................|
||||||||||||||||||||||||||||||||||
