||||||||||||||||||||||||||||||||||||||||
|....||..........................||....|
|.||.||.||||.||..........||.||||.||.||.|
|.||.||.|__|.||.||||||||.||.|__|.||.||.|
|.||.||.||||.||....||....||.||||.||.||.|
|.||.........||.||.||.||.||.........||.|
|.|||||.||.||||.||.||.||.||||.||.|||||.|
|.|||||.||.||||.||.||.||.||||.||.|||||.|
|.||....||....................||....||.|
|.||.||.||||.||.||||||||.||.||||.||.||.|
|.||.||.||||.||.||||||||.||.||||.||.||.|
|....||.||...||..........||...||.||....|
|.|||||.||.||||.|||--|||.||||.||.|||||.|
|.|||||.||.||||.|______|.||||.||.|||||.|
|....||.........||||||||.........||....|
|.||.||.||||.||..........||.||||.||.||.|
|.||.||.||||.||.||||||||.||.||||.||.||.|
|.||.........||..........||.........||.|
|.|||||.|||||||.||||||||.|||||||.|||||.|
|.|||||.|||||||.||||||||.|||||||.|||||.|
|......................................|
||||||||||||||||||||||||||||||||||||||||
