||||||||||||||||||||||||||||||||||||||||
|......................................|
|||.||.|||||.||.||||||||.||.|||||.||.|||
|||.||.|||||.||.||||||||.||.|||||.||.|||
|...||.||....||.||....||.||....||.||...|
|.||||.||.|||||..........|||||.||.||||.|
|.||||.||.|||||.||.||.||.|||||.||.||||.|
.............||.||.||.||.||.............
|||.|||||.||.||....||....||.||.|||||.|||
|||.|||||.||.||.||||||||.||.||.|||||.|||
|......||.||.||.|______|.||.||.||......|
|.||||.||.||................||.||.||||.|
|.||||.||.|||||.|||--|||.|||||.||.||||.|
|...||.||.|||||.|______|.|||||.||.||...|
|||.||..........||||||||..........||.|||
__|.||.|||||.||..........||.|||||.||.|__
|||.||.|||||.||.||||||||.||.|||||.||.|||
|.........||.||..........||.||.........|
|||.||.||.||.||.||||||||.||.||.||.||.|||
|||.||.||.||.||.||||||||.||.||.||.||.|||
|...||.||....||....||....||....||.||...|
|.||||.||.||||||||.||.||||||||.||.||||.|
|.||||.||.||||||||.||.||||||||.||.||||.|
|..................||..................|
||||||||||||||||||||||||||||||||||||||||
