||||||||||||||||||||||||||||||||||||||||
|......................................|
|||.||.||||||||.||||||||.||||||||.||.|||
|||.||.||||||||.||||||||.||||||||.||.|||
|...||.......||.||....||.||.......||...|
|||.|||||.||.||..........||.||.|||||.|||
|||.|||||.||.||.||.||.||.||.||.|||||.|||
|...||....||.||.||.||.||.||.||....||...|
|||.||.|||||.......||.......|||||.||.|||
|||.||.|||||.||.||.||.||.||.|||||.||.|||
.............||.||.||.||.||.............
|.||||.|||||.||..........||.|||||.||||.|
|.||||.|||||.||.|||--|||.||.|||||.||||.|
|...||....||.||.|______|.||.||....||...|
|||.||.||.||....||||||||....||.||.||.|||
__|.||.||.||.||..........||.||.||.||.|__
|||.||.||.||.||.||||||||.||.||.||.||.|||
|......||....||..........||....||......|
|||.||.||.||.|||||.||.|||||.||.||.||.|||
|||.||.||.||.|||||.||.|||||.||.||.||.|||
|...||....||.......||.......||....||...|
|.||||.||||||||.||||||||.||||||||.||||.|
|.||||.||||||||.||||||||.||||||||.||||.|
|......................................|
||||||||||||||||||||||||||||||||||||||||
