||||||||||||||||||||||||||||||||||||||||
|......................................|
|.||||.|||||.||..........||.|||||.||||.|
|.||||.|___|.||.||||||||.||.|___|.||||.|
|...||.|||||.||....||....||.|||||.||...|
|||.||.......||.||.||.||.||.......||.|||
|||.||.||.|||||.||.||.||.|||||.||.||.|||
|......||.|||||.||.||.||.|||||.||......|
|.||||.||......................||.||||.|
|.||||.|||||.||.||||||||.||.|||||.||||.|
|...||.|||||.||.||||||||.||.|||||.||...|
|||.||.......||..........||.......||.|||
__|.||.||.|||||.|||--|||.|||||.||.||.|__
|||.||.||.|||||.|______|.|||||.||.||.|||
|......||.......||||||||.......||......|
|||.||.|||||.||..........||.|||||.||.|||
|||.||.|||||.||.||||||||.||.|||||.||.|||
|...||.......||..........||.......||...|
|.||||.||||||||.||||||||.||||||||.||||.|
|.||||.||||||||.||||||||.||||||||.||||.|
|......................................|
||||||||||||||||||||||||||||||||||||||||
