||||||||||||||||||||||||||||||||||||||||
|......................................|
|.||||.|||||.||..........||.|||||.||||.|
|.||||.|||||.||.||.||.||.||.|||||.||||.|
|...||....||.||....||....||.||....||...|
|||.||.||.||.||.||||||||.||.||.||.||.|||
__|.||.||.||.||.||||||||.||.||.||.||.|__
|||.||.||.||.||..........||.||.||.||.|||
|......||....||..........||....||......|
|||.|||||.||.||.|______|.||.||.|||||.|||
|||.|||||.||.||.||||||||.||.||.|||||.|||
..........||................||..........
|||.||.|||||.||.|||--|||.||.|||||.||.|||
|||.||.|||||.||.|______|.||.|||||.||.|||
|...||.......||.||||||||.||.......||...|
|.||||.||.|||||..........|||||.||.||||.|
|.||||.||.|||||.||||||||.|||||.||.||||.|
|......||....||..........||....||......|
|.||||.|||||.||.||||||||.||.|||||.||||.|
|.||||.|||||.||.||||||||.||.|||||.||||.|
|......................................|
||||||||||||||||||||||||||||||||||||||||
