||||||||||||||||||||||||||||||||||||||||
|......................................|
|.||||.|||||.||..........||.|||||.||||.|
|.||||.|||||.||.||.||.||.||.|||||.||||.|
|.........||.||....||....||.||.........|
|.||.||||.||.||.||||||||.||.||.||||.||.|
|.||.||||.||.||.||||||||.||.||.||||.||.|
|.||...||.||.||..........||.||.||...||.|
|.||||.||....||..........||....||.||||.|
|.||||.||.||.||.|______|.||.||.||.||||.|
|.........||.||.||||||||.||.||.........|
|.||.||||.||................||.||||.||.|
|.||.|__|.|||||.|||--|||.|||||.|__|.||.|
|.||.||||.|||||.|______|.|||||.||||.||.|
|.||............||||||||............||.|
|.||||.||.|||||..........|||||.||.||||.|
|.||||.||.|||||.||||||||.|||||.||.||||.|
|.||...||....||..........||....||...||.|
|.||.|||||||.||.||||||||.||.|||||||.||.|
|.||.|||||||.||.||||||||.||.|||||||.||.|
|......................................|
||||||||||||||||||||||||||||||||||||||||
