||||||||||||||||||||||||||||||||||||||||
|......................................|
|.|||||.||||.||.||||||||.||.||||.|||||.|
|.|||||.|__|.||.||||||||.||.|__|.|||||.|
|....||.||||.||.||....||.||.||||.||....|
|.||.||......||..........||......||.||.|
|.||.||.|||||||.||.||.||.|||||||.||.||.|
|.||.||.|||||||.||.||.||.|||||||.||.||.|
..||...............||...............||..
|.|||||.||||.||.||||||||.||.||||.|||||.|
|.|||||.||||.||.|______|.||.||||.|||||.|
|.||.........||..........||.........||.|
|.||.|||||.||||.|||--|||.||||.|||||.||.|
|.||.|||||.||||.|______|.||||.|||||.||.|
|....||......||.||||||||.||......||....|
||||.||.||||.||..........||.||||.||.||||
||||.||.||||.||.||||||||.||.||||.||.||||
..........||................||..........
|.||.||||.||.||.||||||||.||.||.||||.||.|
|.||.||||.||.||.||||||||.||.||.||||.||.|
|.||...||....||....||....||....||...||.|
|.||||.||.||||||||.||.||||||||.||.||||.|
|.||||.||.||||||||.||.||||||||.||.||||.|
|......................................|
||||||||||||||||||||||||||||||||||||||||
