||||||||||||||||||||||||||||||||||||||||
|......................................|
|.||||.||||||||.||||||||.||||||||.||||.|
|.||||.||||||||.||||||||.||||||||.||||.|
|.........||....||....||....||.........|
|.|||||||.||.||.||.||.||.||.||.|||||||.|
|.|||||||.||.||.||.||.||.||.||.|||||||.|
|...||....||.||.||.||.||.||.||....||...|
|||.||.||.||.||..........||.||.||.||.|||
__|.||.||.||.||.||||||||.||.||.||.||.|__
|||.||.||.||.||.|______|.||.||.||.||.|||
|......||......................||......|
|||.|||||.|||||.|||--|||.|||||.|||||.|||
|||.|||||.|||||.|______|.|||||.|||||.|||
|...............||||||||...............|
|||.||.||.|||||..........|||||.||.||.|||
|||.||.||.|||||.||||||||.|||||.||.||.|||
|...||.||....||..........||....||.||...|
|.||||.|||||.||.||||||||.||.|||||.||||.|
|.||||.|||||.||.||||||||.||.|||||.||||.|
|............||..........||............|
||||||||||||||||||||||||||||||||||||||||
