||||||||||||||||||||||||||||||||||||||||
|..................||..................|
|.||||.|||||.|||||.||.|||||.|||||.||||.|
|.||||.|||||.|||||.||.|||||.|||||.||||.|
|.||......||.||..........||.||......||.|
|.||.||||.||.||..........||.||.||||.||.|
|.||.||||.||.||.||.||.||.||.||.||||.||.|
|......||.......||.||.||.......||......|
|.||||.||.|||||....||....|||||.||.||||.|
|.||||.||.|||||.||||||||.|||||.||.||||.|
.............||.|______|.||.............
|.||.||||.||.||..........||.||.||||.||.|
|.||.||||.||.||.|||--|||.||.||.||||.||.|
|.||...||.||.||.|______|.||.||.||...||.|
|.||||.||.||....||||||||....||.||.||||.|
|.||||.||.||.||..........||.||.||.||||.|
.............||.||||||||.||.............
|.||.||||.||.||..........||.||.||||.||.|
|.||.|__|.||.||.||||||||.||.||.|__|.||.|
|.||.||||.||.||.||||||||.||.||.||||.||.|
|.||......||.||....||....||.||......||.|
|.|||||.||||.|||||.||.|||||.||||.|||||.|
|.|||||.||||.|||||.||.|||||.||||.|||||.|
|..................||..................|
||||||||||||||||||||||||||||||||||||||||
