||||||||||||||||||||||||||||||||||||||||
|..................||..................|
|||.||.|||||.|||||.||.|||||.|||||.||.|||
|||.||.|||||.|||||.||.|||||.|||||.||.|||
|...||..........||.||.||..........||...|
|.|||||||.||.||..........||.||.|||||||.|
|.|||||||.||.||.||.||.||.||.||.|||||||.|
|.........||....||.||.||....||.........|
|||.||||||||.||....||....||.||||||||.|||
|||.||||||||.||.||.||.||.||.||||||||.|||
|............||.||.||.||.||............|
|||.|||||.||.||..........||.||.|||||.|||
|||.|||||.||.||.|||--|||.||.||.|||||.|||
|.........||....|______|....||.........|
|.|||||.||||.||.||||||||.||.||||.|||||.|
|.|||||.||||.||..........||.||||.|||||.|
|.||.........||.||||||||.||.........||.|
|.||.||||.||.||....  ....||.||.||||.||.|
|.||.||||.||.|||||.||.|||||.||.||||.||.|
|......||.||.|||||.||.|||||.||.||......|
|.||||.||.||.......||.......||.||.||||.|
|.|__|.||.|||||.||||||||.|||||.||.|__|.|
|.||||.||.|||||.||||||||.|||||.||.||||.|
|......................................|
||||||||||||||||||||||||||||||||||||||||
