||||||||||||||||||||||||||||||||||||||||
|...............||....||...............|
|.|||||.||.||||..........||||.||.|||||.|
|.|||||.||.||||.||.||.||.||||.||.|||||.|
|....||.||...||.||.||.||.||...||.||....|
||||.||.||||.||....||....||.||||.||.||||
||||.||.||||.||.||.||.||.||.||||.||.||||
................||.||.||................
|.|||||.||.||||..........||||.||.|||||.|
|.|||||.||.|__|.||||||||.|__|.||.|||||.|
|....||.||.||||.||||||||.||||.||.||....|
|.||.||.||....................||.||.||.|
|.||.||.|||||||.|||--|||.|||||||.||.||.|
|.||.||.|||||||.|______|.|||||||.||.||.|
|.||............||||||||............||.|
|.|||||.||||.||..........||.||||.|||||.|
|.|||||.||||.||.||||||||.||.||||.|||||.|
|.......||...||..........||...||.......|
|.|||||.||.||||.||||||||.||||.||.|||||.|
|.|||||.||.||||.||||||||.||||.||.|||||.|
|.......||....................||.......|
||||||||||||||||||||||||||||||||||||||||
